3
0
2 2
21 21
b 0 0 0 0 0 0 0 0 0 c 0 0 0 0 0 0 0 0 0 b
0 0 0 0 0 0 0 0 0 x - x 0 0 0 0 0 0 0 0 0
0 0 b 0 0 0 0 0 0 0 0 0 0 0 0 0 0 0 b 0 0
0 0 0 0 0 0 0 0 0 0 0 0 0 0 0 0 0 0 0 0 0
0 0 0 0 b 0 0 0 0 0 0 0 0 0 0 0 b 0 0 0 0
0 0 0 0 0 0 0 0 0 0 0 0 0 0 0 0 0 0 0 0 0
0 0 0 0 0 0 b 0 0 0 0 0 0 0 b 0 0 0 0 0 0
0 0 0 0 0 0 0 0 0 0 0 0 0 0 0 0 0 0 0 0 0
0 0 0 0 0 0 0 0 b 0 0 0 b 0 0 0 0 0 0 0 0
0 x 0 0 0 0 x 0 0 2 1 3 0 0 x 0 0 0 0 x 0
c - 0 0 0 0 0 x 0 3 2 1 0 x 0 0 0 0 0 - c
0 x 0 0 0 0 x 0 0 1 3 2 0 0 x 0 0 0 0 x 0
0 0 0 0 0 0 0 0 b 0 0 0 b 0 0 0 0 0 0 0 0
0 0 0 0 0 0 0 0 0 0 0 0 0 0 0 0 0 0 0 0 0
0 0 0 0 0 0 b 0 0 0 0 0 0 0 b 0 0 0 0 0 0
0 0 0 0 0 0 0 0 0 0 0 0 0 0 0 0 0 0 0 0 0
0 0 0 0 b 0 0 0 0 0 0 0 0 0 0 0 b 0 0 0 0
0 0 0 0 0 0 0 0 0 0 0 0 0 0 0 0 0 0 0 0 0
0 0 b 0 0 0 0 0 0 0 0 0 0 0 0 0 0 0 b 0 0
0 0 0 0 0 0 0 0 0 x - x 0 0 0 0 0 0 0 0 0
b 0 0 0 0 0 0 0 0 0 c 0 0 0 0 0 0 0 0 0 b
0 10 2 <-> 2 10 6
20 10 6 <-> 18 10 2
10 0 4 <-> 10 2 0
10 20 0 <-> 10 18 4
