2
2
2 1
8 8
1 1 b 1 1 b 1 1
1 1 1 1 1 1 1 1
0 x 0 x 0 x 0 x
x 0 x 0 x 0 x 0
0 x 0 x 0 x 0 x
x 0 x 0 x 0 x 0
2 2 2 2 2 2 2 2
2 2 b 2 2 b 2 2
