3
20
0 1
17 20
- - - 0 0 - - 0 0 0 0 - - - - - - - 0 0
- - 0 c 0 0 0 i 0 0 0 0 - - - - - - 0 b
0 0 b 0 0 0 0 0 0 0 0 0 0 - - 0 0 0 c 0
0 0 0 0 x x x 0 - - b 0 3 1 0 0 0 2 0 0
- 0 0 0 0 0 0 0 - - c 0 2 i 0 3 1 0 c 0
- 0 0 0 1 2 3 0 - - 0 0 0 0 0 i 0 0 0 0
- b 0 0 0 x 0 0 - - c 0 0 0 0 - - - 0 0
0 0 0 0 c 0 0 0 0 x 3 2 1 0 0 - - - 0 c
0 0 i 0 0 0 0 0 0 0 0 x x b 0 - - - 0 0
0 0 0 0 0 x x 0 b 0 0 0 0 0 0 - - - 0 0
- - - - 0 0 0 c - - - 0 0 0 0 - - - i 0
- - - - 0 i 0 0 - - - 0 0 0 0 b 0 0 0 0
- - - - 0 0 0 0 - - - i 0 0 0 0 0 0 0 0
- - - - 0 0 0 0 - - - 0 0 x x x 0 0 0 0
0 0 0 b 0 0 0 0 0 0 0 0 0 x x c 0 0 0 0
x x x x 0 0 0 0 c 0 0 0 0 0 0 0 0 x x x
0 0 0 c 0 0 0 0 0 0 0 0 0 0 0 0 0 0 0 0