3
1
1 1
10 10
- - - 0 0 - - 0 0 0
- - 0 c 0 0 0 i 0 0
0 0 b 0 0 0 0 0 0 0
0 0 0 0 x x x 0 - -
- 0 0 0 0 0 0 0 - -
- 0 0 0 1 2 3 0 - -
- b 0 0 0 x 0 0 - -
0 0 0 0 c 0 0 0 0 x
0 0 i 0 0 0 0 0 0 0 
0 0 0 0 0 x x 0 b 0 
