2
2
3 1
25 25
0 0 0 0 0 0 0 0 - 0 0 0 0 0 0 0 0 - 0 0 0 0 0 0 0
0 c 0 0 0 0 0 i - 0 c 0 0 b 0 0 0 - 0 i 0 b 0 0 0
0 0 0 1 2 0 0 0 - 0 0 0 0 1 2 0 0 - 0 0 1 2 0 0 0
0 0 0 1 2 0 0 0 - 0 0 0 0 1 2 0 0 - 0 0 1 2 0 0 0
0 0 b 0 0 0 0 0 - 0 0 0 c 0 0 0 0 - 0 i 0 0 0 0 0
0 0 0 0 0 0 i 0 - 0 0 0 0 0 0 0 0 - 0 0 0 0 b 0 0
- - - - - - - - - - - - - - - - - - - - - - - - -
0 0 0 0 0 0 0 0 - 0 0 0 0 0 0 0 0 - 0 0 0 0 0 0 0
0 c 0 0 0 0 0 i - 0 c 0 0 b 0 0 0 - 0 i 0 b 0 0 0
0 0 0 1 2 0 0 0 - 0 0 0 0 1 2 0 0 - 0 0 1 2 0 0 0
0 0 0 1 2 0 0 0 - 0 0 0 0 1 2 0 0 - 0 0 1 2 0 0 0
0 0 b 0 0 0 0 0 - 0 0 0 c 0 0 0 0 - 0 i 0 0 0 0 0
0 0 0 0 0 0 i 0 - 0 0 0 0 0 0 0 0 - 0 0 0 0 b 0 0
- - - - - - - - - - - - - - - - - - - - - - - - -
0 0 0 0 0 0 0 0 - 0 0 0 0 0 0 0 0 - 0 0 0 0 0 0 0
0 c 0 0 0 0 0 i - 0 c 0 0 b 0 0 0 - 0 i 0 b 0 0 0
0 0 0 1 2 0 0 0 - 0 0 0 0 1 2 0 0 - 0 0 1 2 0 0 0
0 0 0 1 2 0 0 0 - 0 0 0 0 1 2 0 0 - 0 0 1 2 0 0 0
0 0 b 0 0 0 0 0 - 0 0 0 c 0 0 0 0 - 0 i 0 0 0 0 0
0 0 0 0 0 0 i 0 - 0 0 0 0 0 0 0 0 - 0 0 0 0 b 0 0
- - - - - - - - - - - - - - - - - - - - - - - - -
0 i b c b c i 0 - 0 i b c b c i 0 - 0 i b c b c i
0 0 0 0 0 0 0 0 - 0 0 0 0 0 0 0 0 - 0 0 0 0 0 0 i
0 0 0 0 0 0 0 0 - 0 0 0 0 0 0 0 0 - 0 0 0 0 0 0 0
0 0 0 0 0 0 0 0 - 0 0 0 0 0 0 0 0 - 0 0 0 0 0 0 0




