4
8
2 1
16 16
- - - - - 0 0 0 0 0 0 - - - - -
- - - - - 0 0 0 0 c 0 - - - - -
- - - - - 0 0 0 0 0 0 - - - - -
- - - - - 0 0 x 0 0 0 - - - - -
- - - - 0 0 0 0 0 0 0 0 - - - -
0 0 0 0 0 0 0 0 0 0 0 0 0 0 0 0
0 0 0 b 0 0 1 2 3 4 0 0 0 0 0 0
0 0 0 0 0 0 4 1 2 3 0 0 0 b 0 0
0 0 0 0 0 i 3 4 1 2 0 0 0 0 0 0
0 0 x 0 0 0 2 3 4 1 0 0 0 i 0 0
0 0 0 0 0 0 0 0 0 0 0 0 0 0 0 0
- - - - 0 0 0 0 0 c 0 0 - - - -
- - - - - 0 0 0 0 0 0 - - - - -
- - - - - 0 0 b 0 0 0 - - - - -
- - - - - 0 0 0 0 0 0 - - - - -
- - - - - 0 0 0 0 0 0 - - - - -
7 0 0 <-> 7 15 4
8 0 0 <-> 8 15 4
0 7 6 <-> 15 7 2
0 8 6 <-> 15 8 2