2
0
1 1
5 5
2 2 - - -
2 2 - - -
- - - 1 -
2 1 - - -
2 2 - - -
3 2 2 <-> 1 4 3