4
5
6 1
34 26
- - - - - - - - - - - - - - - - - - - - - - - - - -
- - - - - - - - - 0 0 0 0 0 0 0 0 - - - - - - - - -
- - - - - - - - - 0 0 0 0 0 0 0 0 - - - - - - - - -
- - - - - - - - - 0 0 0 0 0 0 0 0 - - - - - - - - -
- - - - - - - - - 0 0 0 1 2 0 0 0 - - - - - - - - -
- - - - - - - - - 0 0 0 2 1 0 0 0 - - - - - - - - -
- - - - - - - - - 0 0 0 0 0 0 0 0 - - - - - - - - -
- - - - - - - - - 0 0 0 0 0 0 0 0 - - - - - - - - -
- - - - - - - - - 0 0 0 0 0 0 0 0 - - - - - - - - -
- - - - - - - - - 0 0 0 0 0 0 0 0 - - - - - - - - -
- - - - - - - - - 0 0 0 0 0 0 0 0 - - - - - - - - -
- - - - - - - - - 0 0 0 0 0 0 0 0 - - - - - - - - -
- - - - - - - - - 0 0 0 2 3 0 0 0 - - - - - - - - -
- - - - - - - - - 0 0 0 3 2 0 0 0 - - - - - - - - - 
- - - - - - - - - 0 0 0 0 0 0 0 0 - - - - - - - - -
- - - - - - - - - 0 0 0 0 0 0 0 0 - - - - - - - - -
- - - - - - - - - 0 0 0 0 0 0 0 0 - - - - - - - - -
- 0 0 0 0 0 0 0 0 0 0 0 0 0 0 0 0 0 0 0 0 0 0 0 0 -
- 0 0 0 0 0 0 0 0 0 0 0 0 0 0 0 0 0 0 0 0 0 0 0 0 -
- 0 0 0 0 0 0 0 0 0 0 0 0 0 0 0 0 0 0 0 0 0 0 0 0 -
- 0 0 0 3 4 0 0 0 0 0 0 1 3 0 0 0 0 0 0 1 4 0 0 0 -
- 0 0 0 4 3 0 0 0 0 0 0 3 1 0 0 0 0 0 0 4 1 0 0 0 -
- 0 0 0 0 0 0 0 0 0 0 0 0 0 0 0 0 0 0 0 0 0 0 0 0 -
- 0 0 0 0 0 0 0 0 0 0 0 0 0 0 0 0 0 0 0 0 0 0 0 0 -
- 0 0 0 0 0 0 0 0 0 0 0 0 0 0 0 0 0 0 0 0 0 0 0 0 -
- - - - - - - - - 0 0 0 0 0 0 0 0 - - - - - - - - -
- - - - - - - - - 0 0 0 0 0 0 0 0 - - - - - - - - -
- - - - - - - - - 0 0 0 0 0 0 0 0 - - - - - - - - -
- - - - - - - - - 0 0 0 2 4 0 0 0 - - - - - - - - -
- - - - - - - - - 0 0 0 4 2 0 0 0 - - - - - - - - -
- - - - - - - - - 0 0 0 0 0 0 0 0 - - - - - - - - -
- - - - - - - - - 0 0 0 0 0 0 0 0 - - - - - - - - -
- - - - - - - - - 0 0 0 0 0 0 0 0 - - - - - - - - -
- - - - - - - - - - - - - - - - - - - - - - - - - -
1 17 0 <-> 9 9 6
2 17 0 <-> 9 10 6
3 17 0 <-> 9 11 6
4 17 0 <-> 9 12 6
5 17 0 <-> 9 13 6
6 17 0 <-> 9 14 6
7 17 0 <-> 9 15 6
8 17 0 <-> 9 16 6
17 17 0 <-> 16 16 2
18 17 0 <-> 16 15 2
19 17 0 <-> 16 14 2
20 17 0 <-> 16 13 2
21 17 0 <-> 16 12 2
22 17 0 <-> 16 11 2
23 17 0 <-> 16 10 2
24 17 0 <-> 16 9 2
9 1 0 <-> 9 32 4
10 1 0 <-> 10 32 4
11 1 0 <-> 11 32 4
12 1 0 <-> 12 32 4
13 1 0 <-> 13 32 4
14 1 0 <-> 14 32 4
15 1 0 <-> 15 32 4
16 1 0 <-> 16 32 4
9 1 6 <-> 1 24 6
9 2 6 <-> 1 23 6
9 3 6 <-> 1 22 6
9 4 6 <-> 1 21 6
9 5 6 <-> 1 20 6
9 6 6 <-> 1 19 6
9 7 6 <-> 1 18 6
9 8 6 <-> 1 17 6
16 1 2 <-> 24 24 2
16 2 2 <-> 24 23 2
16 3 2 <-> 24 22 2
16 4 2 <-> 24 21 2
16 5 2 <-> 24 20 2
16 6 2 <-> 24 19 2
16 7 2 <-> 24 18 2
16 8 2 <-> 24 17 2
1 24 4 <-> 9 32 6
2 24 4 <-> 9 31 6
3 24 4 <-> 9 30 6
4 24 4 <-> 9 29 6
5 24 4 <-> 9 28 6
6 24 4 <-> 9 27 6
7 24 4 <-> 9 26 6
8 24 4 <-> 9 25 6 
17 24 4 <-> 16 25 2
18 24 4 <-> 16 26 2
19 24 4 <-> 16 27 2
20 24 4 <-> 16 28 2
21 24 4 <-> 16 29 2
22 24 4 <-> 16 30 2
23 24 4 <-> 16 31 2
24 24 4 <-> 16 32 2
