4
1
3 1
28 24
- - - - - - - - 0 0 0 0 0 0 0 0 - - - - - - - -
- - - - - - 0 0 0 0 0 b 0 0 0 0 0 0 - - - - - -
- - - - 0 0 0 0 0 0 0 0 0 0 0 0 0 0 0 0 - - - -
- - - 0 0 0 0 0 0 0 0 0 0 0 0 0 0 x 0 0 0 - - -
- - 0 0 0 0 0 0 0 0 0 0 0 0 0 0 0 0 0 0 0 0 - -
- - 0 0 0 0 0 0 - - - - - - - - 0 0 0 0 0 0 - -
- 0 0 3 4 0 0 - - 0 b 0 0 0 0 - - 0 0 0 0 0 0 -
- 0 0 4 3 0 0 - - 0 0 0 0 0 0 - - 0 0 0 0 0 0 -
- 0 0 0 0 0 0 - - 0 0 0 0 0 0 - - 0 0 2 1 0 0 -
- 0 0 0 0 0 0 - - 0 0 0 0 0 0 - - 0 0 1 2 0 0 -
- - - - - - - - - - - - - - - - - 0 0 0 0 0 0 -
- - - - - - - - - - - - - - - - 0 0 0 0 0 0 0 -
- - - - - - - - - 0 0 0 0 0 0 - 0 0 0 0 0 0 - -
- - - - - - - - - 0 0 0 0 0 0 - 0 0 0 b 0 - - -
- - - - - - - - - 0 0 0 0 0 0 - 0 0 0 0 - - - - 
- - - - - - - 0 - 0 0 0 0 0 0 - 0 0 0 - - - - -
- - - - - - 0 0 - 0 1 2 3 4 0 - 0 0 - - - - - -
- - - - - 0 0 i - 0 4 1 2 3 0 - 0 - - - - - - -
- - - - 0 0 0 0 - 0 3 4 1 2 0 - - - - - - - - -
- - - 0 0 0 0 0 - 0 2 3 4 1 0 - - - - - - - - -
- - 0 0 c 0 0 0 - 0 0 0 0 0 0 - - - - - - - - -
- 0 0 0 0 0 0 0 - 0 0 0 0 0 0 - - - - - - - - -
0 0 0 0 0 0 0 - - 0 0 0 0 0 0 - - - - - - - - -
0 0 0 0 0 0 0 0 - 0 0 0 0 0 0 - 0 0 0 0 0 0 0 0
0 0 0 4 3 0 0 0 - 0 0 0 0 0 0 - 0 0 0 1 2 0 0 0
0 0 0 3 4 0 0 0 - 0 0 i 0 0 0 - 0 0 0 2 1 0 0 0
0 0 0 0 0 0 0 0 - 0 0 0 0 0 0 - 0 0 0 0 0 0 0 0
0 0 0 0 0 0 0 0 - 0 0 0 0 0 0 - 0 0 0 0 0 0 b 0
