4
25
10 5
25 25
0 0 0 0 0 0 0 0 - 0 0 0 0 0 0 0 0 - 0 0 0 0 0 0 0
0 c 0 0 0 0 0 i - 0 c 0 0 b 0 0 0 - 0 i 0 b 0 0 0
0 0 0 1 2 0 0 0 - 0 0 0 0 1 2 0 0 - 0 0 1 2 0 0 0
0 0 0 3 4 0 0 0 - 0 0 0 0 3 4 0 0 - 0 0 3 4 0 0 0
0 0 b 0 0 0 0 0 - 0 0 0 c 0 0 0 0 - 0 i 0 0 0 0 0
0 0 0 0 0 0 i 0 - 0 0 0 0 0 0 0 0 - 0 0 0 0 b 0 0
- - - - - - - - - - - - - - - - - - - - - - - - -
0 0 0 0 0 0 0 0 - 0 0 0 0 0 0 0 0 - 0 0 0 0 0 0 0
0 c 0 0 0 0 0 i - 0 c 0 0 b 0 0 0 - 0 i 0 b 0 0 0
0 0 0 1 2 0 0 0 - 0 0 0 0 1 2 0 0 - 0 0 1 2 0 0 0
0 0 0 3 4 0 0 0 - 0 0 0 0 3 4 0 0 - 0 0 3 4 0 0 0
0 0 b 0 0 0 0 0 - 0 0 0 c 0 0 0 0 - 0 i 0 0 0 0 0
0 0 0 0 0 0 i 0 - 0 0 0 0 0 0 0 0 - 0 0 0 0 b 0 0
- - - - - - - - - - - - - - - - - - - - - - - - -
0 0 0 0 0 0 0 0 - 0 0 0 0 0 0 0 0 - 0 0 0 0 0 0 0
0 c 0 0 0 0 0 i - 0 c 0 0 b 0 0 0 - 0 i 0 b 0 0 0
0 0 0 1 2 0 0 0 - 0 0 0 0 1 2 0 0 - 0 0 1 2 0 0 0
0 0 0 3 4 0 0 0 - 0 0 0 0 3 4 0 0 - 0 0 3 4 0 0 0
0 0 b 0 0 0 0 0 - 0 0 0 c 0 0 0 0 - 0 i 0 0 0 0 0
0 0 0 0 0 0 i 0 - 0 0 0 0 0 0 0 0 - 0 0 0 0 b 0 0
- - - - - - - - - - - - - - - - - - - - - - - - -
0 i b c b c i 0 - 0 i b c b c i 0 - 0 i b c b c i
0 0 0 0 0 0 0 0 - 0 0 0 0 0 0 0 0 - 0 0 0 0 0 0 i
0 0 0 0 0 0 0 0 - 0 0 0 0 0 0 0 0 - 0 0 0 0 0 0 0
0 0 0 0 0 0 0 0 - 0 0 0 0 0 0 0 0 - 0 0 0 0 0 0 0
0 0 0 <-> 0 24 4
1 0 0 <-> 1 24 4
2 0 0 <-> 2 24 4
3 0 0 <-> 3 24 4
4 0 0 <-> 4 24 4
5 0 0 <-> 5 24 4
6 0 0 <-> 6 24 4
7 0 0 <-> 7 24 4
9 0 0 <-> 9 24 4
10 0 0 <-> 10 24 4
11 0 0 <-> 11 24 4
12 0 0 <-> 12 24 4
13 0 0 <-> 13 24 4
14 0 0 <-> 14 24 4
15 0 0 <-> 15 24 4
16 0 0 <-> 16 24 4
18 0 0 <-> 18 24 4
19 0 0 <-> 19 24 4
20 0 0 <-> 20 24 4
21 0 0 <-> 21 24 4
22 0 0 <-> 22 24 4
23 0 0 <-> 23 24 4
24 0 0 <-> 24 24 4



