4
50
3 3
25 25
c 0 0 c 0 0 0 0 0 c 0 0 0 b 0 0 i 0 0 0 0 0 0 0 b
0 0 1 2 b 0 0 0 0 0 0 0 0 0 0 0 0 0 0 0 3 4 0 0 0
0 0 3 4 0 0 0 0 0 0 0 0 0 0 0 0 0 0 0 0 2 1 0 0 0
0 0 0 0 0 0 0 0 0 0 0 0 0 0 0 0 0 0 0 0 0 0 0 0 0
0 0 0 0 0 - - - - - - - - - - - - - - 0 0 0 0 0 0
b 0 0 0 0 - x 0 0 0 0 0 0 0 0 0 0 x - 0 0 0 0 0 0
0 0 0 0 0 - 0 0 0 0 0 0 0 0 0 0 0 0 - 0 0 0 b 0 0
0 0 0 0 0 - 0 0 0 0 0 0 0 0 0 0 0 0 - 0 0 0 0 0 0
0 0 0 0 0 - 0 0 c 0 0 0 0 0 0 0 0 0 - 0 0 0 0 0 0
0 0 0 0 c - 0 0 0 0 0 0 0 0 0 0 0 0 - 0 0 0 0 0 0
0 0 0 0 0 - 0 0 0 0 0 0 0 0 0 0 0 0 - 0 0 b 0 0 0
0 0 0 0 b - 0 0 0 0 0 1 2 0 0 0 0 0 - 0 0 0 0 0 0
i 0 0 0 0 - 0 0 0 0 0 4 3 0 0 0 0 0 - 0 0 0 0 0 0
0 0 0 0 0 - 0 0 0 0 0 0 0 0 0 0 0 0 - 0 0 0 0 0 0
0 0 0 0 0 - 0 0 0 0 0 0 0 0 0 0 0 0 - 0 0 0 0 0 0
0 0 0 0 0 - 0 0 i 0 0 0 0 0 0 0 0 0 - 0 0 0 0 c 0
0 0 0 0 b - 0 0 0 0 0 0 b 0 0 0 0 0 - 0 0 0 0 0 0
c 0 0 0 b - 0 0 0 0 0 0 0 0 0 0 0 0 - 0 0 i 0 0 0
0 0 0 0 0 - x 0 0 0 0 0 0 0 0 0 0 x - 0 0 0 0 0 0
0 0 0 0 0 - - - - - - - - - - - - - - 0 0 0 0 0 0
0 0 0 0 0 0 0 0 0 0 0 0 0 0 0 0 0 0 0 0 0 0 0 0 0
0 0 2 1 0 0 0 0 0 0 0 0 0 0 0 0 0 0 0 0 4 3 0 0 0
0 0 4 3 0 0 0 0 0 0 0 0 0 0 0 0 0 0 0 0 1 2 0 0 0
0 0 0 0 i 0 0 0 0 0 0 0 0 0 0 0 0 0 0 0 0 0 0 0 0
b 0 0 0 c 0 0 0 0 0 0 0 0 0 0 0 0 0 0 0 0 0 0 0 c
4 3 3 <-> 6 5 7
17 5 1 <-> 19 3 5
4 20 1 <-> 6 18 5
17 18 3 <-> 19 20 7
6 3 4 <-> 6 5 0
7 3 4 <-> 7 5 0
8 3 4 <-> 8 5 0
9 3 4 <-> 9 5 0
10 3 4 <-> 10 5 0
11 3 4 <-> 11 5 0
12 3 4 <-> 12 5 0
13 3 4 <-> 13 5 0
14 3 4 <-> 14 5 0
15 3 4 <-> 15 5 0
16 3 4 <-> 16 5 0
17 3 4 <-> 17 5 0
6 18 4 <-> 6 20 0
7 18 4 <-> 7 20 0
8 18 4 <-> 8 20 0
9 18 4 <-> 9 20 0
10 18 4 <-> 10 20 0
11 18 4 <-> 11 20 0
12 18 4 <-> 12 20 0
13 18 4 <-> 13 20 0
14 18 4 <-> 14 20 0
15 18 4 <-> 15 20 0
16 18 4 <-> 16 20 0
17 18 4 <-> 17 20 0